# Corpus: Araneum Russicum II Maximum (Russian, 17.03) 13,6 G
# Hits: 179
#      Query    "ударить" []{1,2} [word="молния"] 179
vashasobaka.com.ua	             собрал он и велел человеку встать отдельно. 	 Ударила огромная молния 	 и расколола плато на две части: на одной             	
umniki.ru	           обгоревший ствол, и столь явной причиной, как 	 ударившая в него молния 	. Поэтому плести длиннейшие цепочки неверных          	
v1.anekdot.ru	           набросился орел и поднял его в поднебесье - и 	 ударила по орлу молния 	 и упал он с мячом в клюве в море..а море             	
lib.pravmir.ru	              после. Они сейчас такие, словно их молнией 	 ударило. Если молния 	 попадает в дерево, то разве оно не становится        	
mansbest.ru	               настоящая любовь, большая и единственная, 	 ударит как молния 	. «Но любовь с первого взгляда не есть любовь         	
dom-knigi.ru	                туч уже встала над миром, и скоро из нее 	 ударит первая молния 	. Агент-нелегал русской разведки, гимназист-грабитель 	
antclub.org	               мне согреешь. Скорее мой народ ты оживи!» 	 Ударил гром и молния 	 блеснула Эак услышал голос с высоты: «Не             	
coachexpert.info	              ))) И прямо, как у настоящих творцов, идея 	 ударила,как молния 	.Сядь напиши про это своим читателям и читательницам  	
asino.4geo.ru	                искать убежища под деревом. Там в него и 	 ударила первая молния 	. Когда он упал от удара, молния ударила              	
stimmi.ru	              утро, стоило мне открыть глаза, как в мозг 	 ударила шаровая молния 	 мысли. Я забыл ее уже часа через два, но             	
ruslit.net	                , выкрикивая колдовские слова. В мой щит 	 ударила ослепительная молния 	 и отразившись, попала в одного из моих               	
ruslit.net	              слово, правую руку охватило сияние и с неё 	 ударила ослепительная молния 	. Мгновенно пролетев метров двадцать, разряд          	
buran.ru	                37-ой секунде полета в ракету "Сатурн-5" 	 ударила первая молния 	. Вспышку молнии увидел из членов экипажа             	
pyatzvezd.ru	              нас предупредили, что музей после пожара ( 	ударила шаровая молния 	) и по этой причине, заходить в здания мы             	
salamand.ru	           свечение, то стало уже действительно страшно. 	 Ударит в ледоруб молния 	, и все, прощай человечек. Пришлось тащить            	
karelidas.eu	              дверцей, точно в то место, где стоял Саша, 	 ударила долгая синяя молния 	. Я буду просто смотреть в окно… — Садись             	
dumskaya.net	               уроке физкультуры погибла девочка - в нее 	 ударила молния : молния 	 бывает не только в дождь, просто неудачное           	
salamand.ru	               для древних людей был связан с пожарами – 	 ударит в дерево молния 	 или загорится трава, когда капелька воды             	
argo-school.ru	                 не окрашена. Поэтому предмет, в который 	 ударит [молния 	], приходит в движение еще прежде удара,              	
planetamagii.forumbelarus.com	            цепей, неведомо откуда, из безоблачного неба 	 ударила ослепительная молния 	 в жезл Царя, и весь Его Облик сразу окутался         	
admdankov.ru	                 — переждите 20-30 минут после того, как 	 ударила последняя молния 	. Нельзя: перемещаться, прятаться в стога             	
broker-agent.ru	                любой ситуации – попал ли в него кирпич, 	 ударила ли молния 	, разбил ли соседский мальчишка лобовое               	
insbrokers.ru	             точно нельзя, — это пожар. "В трубу ее дачи 	 ударила обычная молния 	. В результате крайне сильного перепада               	
ruslit.net	          лягушка, и замахал руками. Вспыхнуло, в костер 	 ударила синевато-белая молния 	, и горящие ветви разбросало в стороны.               	
ruslit.net	         временем скелет в лохмотьях, с большим промахом 	 ударила разок подземная молния 	, да еще Фома ушиб колено о некстати подвернувшуюся   	
stalker-game.com	             глаза и захотел изо всех сил проснуться, но 	 ударившая невдалеке молния 	 дала повод считать происходящее мрачной              	
schirtec.kiev.ua	               школьникам в походе держаться за веревку. 	 Ударившая в веревку молния 	 убила каждого четного ребенка в ряду, оставив        	
lib.el-cap.kiev.ua	                  "...Когда мы были уже у самой вершины, 	 ударила такая потрясающая молния 	, что заколебались скалы, а четырех наших             	
pustunchik.ua	                 века , когда дубу было лет 500 , в него 	 ударила мощная молния 	. Но могучее дерево выжило, несмотря на               	
speleolog.kiev.ua	                : от этого зависела моя безопасность. Не 	 ударила ли молния 	 в кабель на поверхности, что неоднократно            	
gaz.lviv.ua	                 сделала! Заклинания увечья и разрушения 	 ударили, словно молния 	, в замкнутом пространстве пещеры, и Дженни           	
schirtec.kiev.ua	             счету, сокращает жизнь, независимо от того, 	 ударит в вас молния 	 или обойдет стороной. Скорее всего, мужчины          	
vist.kharkov.ua	            больше длинна самого провода. Так что просто 	 ударившая рядом молния 	 может запросто натворить кучу делов. Кстати          	
supernaturaltv.ru	              ливню чуточку уняться, как совсем недалеко 	 ударила еще одна молния 	, прокатилась по всем четырем полосам Белл-стрит      	
raybradbury.ru	               моих плеч, а затем — кончика носа. В меня 	 ударила маленькая молния 	. Мистер Электрико воскликнул: «Живи вечно            	
bibliogid.ru	         говорила «мамочки-мамочки» и всё спрашивала, не 	 ударит ли молния 	 в наш дом. Я — после каждой, ослепительно            	
emilezola.ru	             носила на руках, и продолжая его укачивать. 	 Ударил гром; молния 	, очевидно, сразила соседнее дерево, и оно            	
domduha.ru	             дерево, под которым он только что прятался, 	 ударила невероятно мощная молния 	. Так и вышло, что кот спас жизнь очень               	
aquarun.ru	             неожиданно для себя зажмурился, ему в глаза 	 ударила ослепительная молния 	. Нет, даже не молния, а целый всполох всего          	
atheism.ru	               Те, кто читал мой твиттер делали ставки - 	 ударит ли молния 	 по безбожникам или нет. В результате обошлось        	
strangearts.ru	            только они начали транспортировку, в Инерцию 	 ударила красная молния 	 огромной силы, которая освободила Обратного          	
rulit.org	              -Да нет ничего. А ты можешь сделать, чтобы 	 ударила настоящая молния 	? -Конечно, могу, это как раз довольнопростое         	
rulit.org	                 боги на Азамата. Прямо в грудь храбреца 	 ударила ослепительная молния 	. Сбросил могучий Тулпор джигита прямо в              	
rusvera.mrezha.ru	               на землю, к ужасу собравшихся. Но гром не 	 ударил, и молния 	 не сверкнула. В 41-м году Андрон добровольцем        	
magazines.russ.ru	            будущие неземные наслаждения. Приезд невесты 	 ударил как молния 	. Солдат обуглился вмиг, вмиг сгорев от               	
dreamworlds.ru	            присоединились сэлвийские колдуны. С треском 	 ударила ослепительно белая молния 	, заживо испепеляя тех, кому не повезло               	
lib.web-malina.com	            раскат расколол небо в третий раз, и в землю 	 ударила слепящая молния 	. Она не исчезла, а продолжала блистать,              	
lib.ru	               природа Быть спутниками вечно. В ту скалу 	 Ударила раз молния 	. Расселась Она глубоко, и один ручей Иссяк           	
lib.web-malina.com	              как раз на уровне головы Майлза, с треском 	 ударила голубая молния 	. Нейробластер! Великан дернулся - и перестал         	
kursk.bezformata.ru	                  спрашиваю я бабушку. - Когда-то в него 	 ударила шаровая молния 	, - невозмутимо отвечает она. Мою бабушку             	
masterkosta.com	              лярвы суть, хорошо чувствуют себя, пока не 	 ударит в них молния 	 невидимая, пока не познает их внутреннее             	
ezoteriki.com	               думал он. И решил тогда Серегей, что если 	 ударит хоть одна молния 	 впереди, то повернёт он назад. Но тут случилось      	
golovachev.ru	                 ближе, направил острие посоха на кочку. 	 Ударила неяркая фиолетово-сиреневая молния 	. Снег на вершине кочки испарился, облачко            	
dreamland-exit.info	              нескольких направлениях. Где на самом деле 	 ударила эта молния 	? A: Ячейка была равномерно распределена              	
paganism.msk.ru	             великая, голос Рода - гром небеса потряс, и 	 ударила в уточку молния 	. Род вдохнул тем силу великую бурей грозною          	
dayudm.ru	                 - переждите 20-30 минут после того, как 	 ударила последняя молния 	. Ни в коем случае нельзя прятаться в стога           	
proza.ru	                Самодовольное лицо Маркина. «Дежа вю», – 	 ударило, как молния 	, воспоминание. – «Это кино я уже смотрел             	
planeta.moy.su	             услышал сильный гром. Когда братья вылезли, 	 ударила третья молния 	 уже в другом месте неба. Снова гром и ветер          	
leninism.su	                , другая о романе Тургенева «Накануне» — 	 ударили, как молния 	. Я, конечно, и до этого читал «Накануне              	
aservis.vx9.ru	            кому-то из моих союзников, потому что с неба 	 ударила изумительная голубая молния 	, причем я ее не вызывал. Итак, я все еще             	
lib.ru	              пятно среди каменного крошева, и сейчас же 	 ударила вторая молния 	. - Вперед! Вперед! - заорал он, не слыша             	
dokumentika.org	            область), военные практически сразу заявили: 	 ударила шаровая молния 	; она-де, одна-единственная, и вызвала пожар          	
katryndemina.ru	         творческая энергия нашла, наконец, свой канал и 	 ударила, как молния 	, необходимо уединение и время. Отключить             	
proza.ru	                дома. Метрах в пятнадцати-двадцати, куда 	 ударила шаровая молния 	, лежала их кормилица Чернушка, а рядом               	
publy.ru	          исходит из точки, в которую незадолго до этого 	 ударила обычная молния 	. Дело в том, что первая вспышка изменяет             	
divinecosmos.e-puzzle.ru	               последние 600 лет. В ту же ночь в Ватикан 	 ударила огромная молния 	. Я счел удар молнии крупномасштабным легко           	
buttexarx.ru	                У меня везде фильтры. Когда-то в наш дом 	 ударила шаровая молния 	, с экрана аж искры пошли. у соседа сгорел            	
financliga.ru	                 не грянет, мужик не перекрестится». Вот 	 ударила кризисно-санкционная молния 	 и высветился наш очередной экономический             	
svjatogor.by	                на конце стрелой нечистую силу. Там, где 	 ударила его молния 	, находили раздвоенную стрелу или крест,              	
meteoweb.ru	              достигает того места, в которое собирается 	 ударить будущая молния 	. В большинстве случаев, это - Земля, но              	
arcto.ru	                . Вода! Когда же ты хлынешь! Когда же ты 	 ударишь, молния 	! Я вижу этого несчастного, этот странный             	
bradbury.org.ru	              берег. Нет. Нет. Час назад в полевой дымке 	 ударила тончайшая молния 	, когда он собирал под деревом землянику              	
drakan.sosbb.ru	              послышался треск. Из дальнего угла в жрицу 	 ударила сверкающая молния 	. Там пряталась Наттира. Калинда выглянула            	
kirsan.org	         чувствует, кроме цели. Грянет гром над головой, 	 ударит рядом молния 	 — не шелохнется, ни один мускул не дрогнет           	
alpclb.ru	             волосы стали вставать дыбом, Людке по каске 	 ударила маленькая молния 	, и мы поспешили вниз. Спуск проходил в               	
bogyes.ru	              Предупреждением о каре за гордыню является 	 ударившая неподалеку молния 	, особенно до начала дождя. Получить этот             	
crossroad-supernatural.ru	              подчиняются его желанию. В то же мгновение 	 ударила яркая молния 	, которая разорвала небо белой вспышкой,              	
dumaalex.org.ru	           своему любовнику. Едва он очутился у нее, как 	 ударил гром и молния 	 убила лошадь, на которой он только что               	
nvspb.ru	        комплексов в России всего четыре. Но в 2013 году 	 ударила в церковь молния 	, и пока пожарные добирались до погоста               	
onlinerift.ru	              переменным успехом, как вдруг посреди поля 	 ударила мощная молния 	. В бой вступили Меченые бурей. К тому же             	
equestriafim.forumrpg.ru	      загоревшись ярко красным светом, а в жеребца мигом 	 ударила красная молния 	 и его ноги погрузились по колено в каменистую        	
fairy-tales.su	                   шарику и осторожно тронула его лапой. 	Ударила дурака молния 	. Не убила, а способность ему необыкновенную          	
jam-warez.ru	              это всё не то. Арман жаждет любви, которая 	 ударит его как молния 	. Разглагольствуя с приятелями на вечеринке           	
bleachwaytodarkness.forumbb.ru	          разбойников, когда его неожиданно развернули и 	 ударили. Сверкнула молния 	. Тонкая струйка крови потекла вдоль носа             	
twistedfate.liverolka.ru	                 застыл на месте. Гул грома оглушил его, 	 ударила яркая молния 	, на секунду озарив поляну. Монк пытался              	
buhonline.ru	                пополз по комнате, и в этот самый момент 	 ударила вдруг молния 	 в повисший над миром свинец туч, разрывая            	
barkarolla1.webtalk.ru	               школьникам в походе держаться за веревку. 	 Ударившая в веревку молния 	 убила каждого четного ребенка в ряду, оставив        	
intelligentia.ru	         чувствует, кроме цели. Грянет гром над головой, 	 ударит рядом молния 	 — не шелохнется, ни один мускул не дрогнет           	
ufospace.net	                вдруг из нижнего основания "стопки блюд" 	 ударила гигантская наземная молния 	, за ней последовал еще ряд разрядов. Этот            	
alex-berg.ru	           отливом должна быть». В середину поляны вновь 	 ударила изумрудного цвета молния 	, а затем еще и еще пока посреди поляны               	
alex-berg.ru	               рядом еще несколько мелких горошин. Затем 	 ударила вторая молния 	. И вновь «мурашки». Я приподнял собственную          	
alex-berg.ru	               сначала дрогнули а затем сжались в кулак. 	 Ударила третья молния 	. Не знаю сколько я так простоял, рассматривая        	
ura.ru	       обрушенные ветром сосны, а жительницу Златоуста — 	 ударившая в палатку молния 	. Более десятка человек получили травмы,              	
e-vestnik.ru	                событие: во время вечернего богослужения 	 ударившая в храм молния 	 вошла в деревянный иконостас и опалила               	
rostovchanka-media.ru	                дерево, под которым он только что сидел, 	 ударила страшная молния 	! Получилось, что кот спас жизнь такого               	
edinstvennaya.ua	                 к тому же зародится так неожиданно, как 	 ударила в сновидении молния 	. Скорее всего, это будет страсть с первого           	
rozamira.ucoz.ru	               укрытие, а тело Христа положили на землю. 	 Ударившая рядом молния 	 «стекла» на плащаницу и сделала отпечаток            	
rpczmoskva.org.ru	                 в поисках пропитания, случилась гроза и 	 ударила в шалаш молния 	 с небес и огнем сожгла его дотла. Вернувшись         	
m-tz.ru	                желудок и мгновенно стало жарко, будь-то 	 ударила снизу вверх молния 	, похожая на дерево, со стволом и ветками             	
perehodjournal.ru	             меня при совершенно ясном небе в громоотвод 	 ударила небольшая молния 	. Хотя это, возможно, лишь совпадение, мне            	
yantau.ru	            редкое стечение обстоятельств, и только. Ну, 	 ударила в сосну молния 	, ну, загорелись и тлеют горные породы…               	
premija-ru.eu	               они растут, тем тащить тяжелее. И однажды 	 ударила в дерево молния 	, вся белочкина семья погибла, только одного          	
viperson.ru	         небесная стрела, молния таланта и призвания, то 	 ударила эта молния 	, вспыхнула эта искра именно там, в Шахматове         	
serann.ru	                 — розовая обезьяна. С безоблачного неба 	 ударила мощная молния 	. Когда Берт поднялся с пола, одежда на               	
soligalich.smi44.ru	             лето — стала молния. (Утверждают, что в дом 	 ударила шаровая молния 	.) В тушении участвовали три машины ПЧ-19             	
alekseykalugin.ru	                 в грозовое облако. Казалось, вот сейчас 	 ударит гром, молния 	 разорвет облаку брюхо и на траву прольются           	
tainy.net	                 агентства НАСА полагают, что супершторм 	 ударит как молния 	, и повредит всё, начиная от систем аварийных         	
delovoy.net.ua	            назад наступил критический момент: в осколок 	 ударила мощнейшая молния 	, один из беззвучных и невидимых всплесков            	
csdb-samara.ru	              полнеба, а дождя — ну хоть бы капля упала. 	 Ударила тогда молния 	 в сосну на пригорке, загорелась она, глазом          	
delovoy.net.ua	                 и лопнула. Когда отчима хоронили, в дом 	 ударила шаровая молния 	 и сожгла его дотла. Судьба Джеймса и деньги          	
nkozlov.ru	                 на сердце, скажут, что в них непременно 	 ударила бы молния 	. Хотя следы садизма и мазохизма присущи              	
moscowfamily.ru	              Раньше я такого никогда не видела. В крест 	 ударила шаровая молния 	.Она ополила бородуна иконе Иисуса и несколько        	
abstrugatskie.ru	                дверь как раз в тот момент, когда в стол 	 ударила первая молния 	. Я шарахнулся. Голос Витьки рявкнул какое            	
ua4cgr.narod.ru	              увидели как впереди по курсу несколько раз 	 ударила высокая вертикальная молния 	. Это было где то в предполагаемой точке              	
russights.ru	               Дмитриевской церкви озарилось огнем, сюда 	 ударила мощная молния 	, кровля сильно пострадала от огня. Епархией          	
warriorakademy.spybb.ru	           впереди. И в этот момент в небе над крепостью 	 ударила чёрная молния 	. - Ты видела? – обратилась девушка к воздуху         	
oncinema.info	             глазах, когда он еще был маленьким. Женщину 	 ударила шаровая молния 	, но в ее смерти обвинили невиновного отца            	
enirin.ru	             давно - стоит лишь сжать кристалл, как тебя 	 ударит "слабая молния 	". Действие кварца магического основывается           	
bdn-steiner.ru	                хриплый смех и крики ликованья В мой сон 	 ударили, как молния 	 во тьму. Стучат по сердцу, как по наковальне         	
lib.rus.ec	                движение руками, и от него в мою сторону 	 ударила зеленая молния 	. Спасли меня интуиция и то, что за мгновение         	
lib.rus.ec	             заранее придуманному плану. В дракона сразу 	 ударила зеленая молния 	 и какое‑то заклятье. ‑ У дракона вот с               	
lib.rus.ec	          невесть откуда налетела тяжелая грозовая туча, 	 ударили гром и молния 	. Посыпался град. Оплакивая проклятых, ливень         	
fargate.ru	            подумал что-то вроде «О, Боже, в меня сейчас 	 ударит карающая молния 	»? ДЖЕНСЕН: У моей бабушки прямая линия               	
love.38i.ru	                почувствовать друг друга. Если любовь не 	 ударила, как молния 	, это не значит, что было не то и не так              	
fan.lib.ru	               не посмеешь, дракон! Я усмехнулся. С неба 	 ударила пурпурная молния 	, вспышка света обрисовала в воздухе свиток           	
story.votpusk.ru	              года случилось несчастье. В здание усадьбы 	 ударила шаровая молния 	, и начался пожар. Все это происходило в              	
det.lib.ru	            поднял лицо к небу. Оттуда, из черной бездны 	 ударила в землю молния 	. Максимов увидел человека, черной куклой             	
mahanenko.ru	                щит, покрывая с головы до ног, в который 	 ударила черная молния 	, не причинив урона, но отбросив на несколько         	
fan.lib.ru	         священник, долго ожидавший подходящего момента, 	 ударил как молния 	. Маленький череп, хрустнув, раскололся,              	
vanessalee.ru	                что-то подобное в пионерском лагере: Там 	 ударила обычная молния 	, потом как будто скрутилась в клубок и               	
fan.lib.ru	              половине слова. В чашу фонтана из ниоткуда 	 ударила сиреневая молния 	, миг спустя последовал оглушительный громовой        	
fan.lib.ru	             взмахнул копьем, с кончика острия в Варнаву 	 ударила зеленоватая молния 	. Тот, впрочем, был уже готов. Последние              	
fan.lib.ru	            словно дровосек рубанул сверху вниз. С небес 	 ударила длинная ветвистая молния 	, и нерушимая прежде защита Большого Илима            	
myshared.ru	               окна, не допускать сквозняка, иначе может 	 ударить шаровая молния 	 Нельзя топить печь, потому что дым имеет             	
zametkielectrika.ru	              сам. У меня был случай когда в электросеть 	 ударила шаровая молния 	 и перенапряжение было миллионы вольт. По             	
novosti.ae	                Вчера, 19 января, поздно вечером в Дубае 	 ударила сильнейшая молния 	. Молния осветила небо Дубая и раскаты грома          	
knizhnik.org	           восстал с земли богатырь и поднял свой меч, и 	 ударили гром и молния 	, и разбежались нехристи-язычники в разные            	
rus.1september.ru	               больше чем людей видевш_х место в которое 	 ударила обычная молния 	. В наш_й стране данные наблюдений за шаровыми        	
rus.1september.ru	            больше, чем людей, видевших место, в которое 	 ударила обычная молния 	. В нашей стране данные наблюдений за шаровыми        	
misterium-rpg.ru	              Небесной молнии , с той лишь разницей, что 	 ударив единожды, молния 	 не прекращает бить, она соединяет небеса             	
litkniga.ru	                 Девушка подалась вперед, и тотчас в нее 	 ударила сильнейшая молния 	. – Держите ее! – Раздался запоздалый крик            	
pisatel.forumbb.ru	                Смерть'. В охваченного агонией двуглавца 	 ударила красная молния 	. На землю посыпались тысячи опаленных пчёл           	
misterium-rpg.ru	                 ещё перегораживало путь, а в тело эльфа 	 ударила бирюзовая молния 	, знакомая здесь только Инуэну. Техника               	
artofwar.ru	                поверхность. Метрах в ста от него в воду 	 ударила ослепительно яркая молния 	 и оглушительный грохот ухнул по привыкшим            	
samlib.ru	          сделать. А тучи вдруг разошлись на мгновенье и 	 ударила такая молния 	, какой еще никто не видел. Будто сто молний          	
samlib.ru	              посох и воздел руки к небу. В ответ с неба 	 ударила яркая молния 	, грохотнуло, и на юге что-то взорвалось              	
litlib.net	           Внезапно из широкого рукава его куртки словно 	 ударила тёмная молния 	. Она бы непременно поразила юношу в горло            	
litkniga.ru	                 запоздалое изумление, а потом беззвучно 	 ударила черная молния 	, и та мгновенно осыпалась серым пеплом.              	
forum.tuolordis.ru	               повис, извиваясь и терзая воздух треском. 	 Ударила вторая молния 	. Баргест посмотрел на лапы, сделал ими               	
lib.rus.ec	                 небес, вроде бы совершенно не грозовых, 	 ударила неслышимая молния 	, и Хономер утратил способность осознавать            	
lib.rus.ec	         скрылось, и сразу стало темно. Из грозовой тучи 	 ударила первая молния 	. Она залила всю долину трепещущим мертвенным         	
blog.newsler.ru	               ты ничего этого не делаешь… *** Эти слова 	 ударили словно молния 	 в сердце юной девы и на несколько минут              	
mirymoskvy.ru	               несколько столетий. В 1369 году в минарет 	 ударила гигантская молния 	, серьезно повредившая верхний четвертый              	
hpmor.ru	            изгнан, если он лишит жизни жеребёнка. Копьё 	 ударило, словно молния 	 — слишком быстро, чтобы отреагировать —              	
opentextnn.ru	             огонь, но дело тут в том, что сейчас в него 	 ударила та незримая молния 	, которая подстерегает каждого из нас; она-то         	
fanfics.me	              возник ярко-жёлтый рунный круг из которого 	 ударила мощная молния 	. Задымившаяся и почерневшая туша завалилась          	
violetfire.ru	              что проведите в этот день службу. Пусть же 	 ударит синяя молния 	 Разума Бога! Ибо нам предстоит обуздать              	
kontorovich.ru	            поляны, прорезав зелень и подняв клубы пара, 	 ударила сине-фиолетовая молния 	. Его корпус треснул и оттуда рванулся огонь          	
textonly.ru	           Страшнее? Чем гнев богини? Н е с т о р. Когда 	 ударила эта молния 	… прошло… не знаю сколько, но очень мало              	
svitk.ru	                отчаянии метался в поисках осла. И вдруг 	 ударила яркая молния 	, осветившая небо и весь подлунный мир,               	
lib.rus.ec	            кулаки сжались, а в землю у самых ног принца 	 ударила предупредительная молния 	. – Да уж, – прикрыл глаза ладонью рю Мальвей         	
lib.rus.ec	             атаке дракона Мордет был готов. Из его руки 	 ударила черная молния 	, попав прямо в атакующую Крео shy;зот.               	
his.1september.ru	            лошади]. Маршал Ней со своей обычной отвагой 	 ударил, как молния 	, по выдвинутым корпусам неприятельского              	
gimn6.ru	                , он посмотрел наверх, и прямо перед ним 	 ударила ослепительная молния 	, разноцветная, казалось, что ее ветви затянули       	
bioware.ru	          занятый последними приготовлениями. Зато когда 	 ударила первая молния 	, и разноцветные столбики индикаторов разом           	
lib.rus.ec	             раненым, точно! Из-за бронелиста неожиданно 	 ударила ветвистая молния 	, изогнулась, ткнувшись в середину смарагда           	
portal-kultura.ru	                , другая о романе Тургенева «Накануне» — 	 ударили как молния 	... Из разбора «Обломова» он сделал клич              	
rmvoz.ru	 прошипело-промурлыкало: «Я Шимасса». Шимасса! Это слово 	 ударило меня словно молния 	. Внезапно я все вспомнил: вспомнил, что              	
sun-expo.ru	              Башкирии росло огромное дерево. Как-то раз 	 ударила в него молния 	, дерево загорелось, а огонь ушёл по его              	
fiz.do.am	             участков. После того как шар исчез, в сарай 	 ударила зигзагообразная молния 	, вызвавшая пожар. В 1877 г. на французском           	
daabyss.rolbb.ru	            секундой. Ждать больше было нельзя, и Сэрбис 	 ударил. Обычная молния 	 обжигает, парализует, даже заставляет жертву         	
yury-musatkin.ru	                плана, Напевала, а он молча слушал. Гром 	 ударил, молния 	 сверкнула, Нет уже надежды на спасенье,              	
litresp.ru	                передавая по земле дрожь вибраций. Затем 	 ударила беззвучная молния 	, и началось… В баре тускло светила единственная      	
geoman.ru	                А ведь в веках ему присуща динамичность. 	 Ударила ли молния 	, ветер ли свалил уже погибшую сосну - не             	
217.16.27.129	        вспыхнула зеленым огнем пентаграмма, а из посоха 	 ударила ветвистая молния 	. Первым под её удар попал Убор. Не успев             	
3k.mail.ru	                выкрикнул заклинание и во второго стража 	 ударила ветвистая молния 	, тот успел отскочить и молния лишь задев             	
tyt-skazki.ru	                руку, прошептала заклинание – и в воздух 	 ударила голубая молния 	. Она прошла чуть в стороне от головы дракона         	
elderscrolls.net	            слабое жужжание в землю из безоблачного неба 	 ударила самая яркая молния 	 из всех, что он видел, и рассекла пространство       	
gothic.ag.ru	            близости Барьера, и вас может весьма ощутимо 	 ударить магическая молния 	. Направляйтесь по дороге вслед за Диего              	

